{
    "tiles_data": [
        [1, 1, 1, 1, 1, 1, 1, 1, 1, 1, 1, 1, 1, 1, 1, 1],
        [1, 1, 1, 3, 3, -1, -1, -1, -1, -1, -1, 1, 1, 1, 1, 1],
        [1, 1, 3, 3, -1, -1, -1, -1, -1, -1, -1, -1, 1, 1, 1, 1],
        [1, 3, 3, 3, -1, -1, -1, -1, -1, -1, -1, -1, -1, -1, 1, 1],
        [1, 3, 3, -1, -1, -1, -1, -1, -1, -1, -1, -1, -1, -1, 1, 1],
        [1, -1, -1, -1, -1, -1, -1, -1, -1, -1, -1, -1, -1, -1, -1, 1],
        [1, -1, -1, -1, -1, -1, -1, -1, -1, -1, -1, -1, -1, -1, -1, 1],
        [1, -1, -1, -1, -1, -1, -1, -1, -1, -1, -1, -1, -1, -1, -1, 1],
        [1, -1, -1, -1, -1, -1, -1, -1, -1, -1, -1, -1, -1, -1, -1, 1],
        [1, -1, -1, -1, -1, -1, -1, -1, -1, -1, -1, -1, -1, -1, -1, 1],
        [1, -1, -1, -1, -1, -1, -1, -1, -1, -1, -1, -1, -1, -1, -1, 1],
        [1, -1, -1, -1, -1, -1, -1, -1, -1, -1, -1, -1, -1, -1, -1, 1],
        [1, -1, -1, -1, -1, -1, -1, -1, -1, -1, -1, -1, -1, -1, -1, 1],
        [1, -1, -1, -1, -1, 7, -1, 4, -1, -1, -1, -1, -1, -1, -1, 1],
        [1, -1, -1, -1, -1, -1, -1, -1, -1, -1, -1, -1, 6, 4, -1, 1],
        [1, -1, -1, -1, -1, -1, 0, 0, 0, -1, -1, -1, 0, 0, 0, 1],
        [1, -1, -1, -1, -1, -1, -1, 1, -1, -1, -1, -1, -1, 1, 1, 1],
        [1, -1, -1, -1, -1, -1, -1, -1, -1, -1, -1, -1, -1, -1, -1, 1],
        [1, -1, 6, 4, -1, -1, -1, -1, -1, -1, -1, -1, -1, -1, -1, 1],
        [1, -1, 3, 3, 3, -1, -1, -1, -1, -1, -1, -1, -1, -1, -1, 1],
        [3, 3, 3, 3, 3, -1, -1, -1, -1, 2, 2, 2, -1, -1, -1, 1],
        [3, 3, 3, -1, -1, -1, -1, -1, -1, -1, 1, -1, -1, -1, -1, 1],
        [3, 3, 3, -1, -1, -1, -1, -1, -1, -1, -1, -1, -1, -1, -1, 1],
        [3, -1, -1, -1, -1, -1, -1, -1, -1, -1, -1, -1, -1, -1, -1, 1],
        [3, -1, -1, -1, -1, -1, -1, -1, 6, -1, -1, -1, -1, -1, -1, 1],
        [3, -1, -1, -1, -1, -1, -1, 3, 3, -1, -1, -1, -1, -1, 3, 1],
        [3, -1, -1, -1, -1, -1, -1, 3, 3, -1, -1, -1, -1, -1, 3, 1],
        [3, -1, -1, -1, -1, -1, -1, -1, 3, 4, -1, 7, -1, 3, 3, 1],
        [3, 3, -1, 5, -1, -1, 3, 3, 3, 3, -1, -1, 3, 3, 1, 1],
        [3, 3, 0, 0, 0, 0, 0, 3, 3, 3, 1, 1, 1, 1, 1, 1]
    ],
    "player_spawn": [72, 672]
}